19 21
111111111111111111111
100000000000000000021
100000000000000000001
100000000000000000001
100000020000000000001
100000000000000000001
101000001111001000001
100000000000000000001
102000000000000000001
100000000000000000001
100000001001000000001
100000000000000000001
100000000000000000001
100000000000000000001
100000000000000000001
100000200000000000001
100000000000000000001
100000000000000000001
111111111111111111111