19 21
111111111111111111111
100000000000000000021
100000000000000000001
100000111111000000001
100000000001000000001
100000000001000000001
100000000001000000001
111111111111000000001
102001000000000000001
100001000000000000001
100111000000000000001
100011000000000000001
100000000001000000001
100000000001000000001
100000000001000000001
100000011111000000001
100000000000000000001
100000000000000000001
111111111111111111111